1 1 0 0 0 1 1 1 1 1 1 9
1 1 1 1 1 0 1 1 0 0 1 9
2 2 0 1 1 1 1 0 0 9
2 2 1 1 1 1 1 1 1 9
1 1 0 0 0 1 1 1 1 1 1 9
1 1 0 0 0 1 1 1 1 1 1 9
1 1 0 0 0 1 1 1 1 1 1 9
1 1 0 0 0 1 1 1 1 1 1 9
2 2 2 2 2 1 9